NO ./xpm_images/AnyConv.com__eagle.xpm
SO ./xpm_images/AnyConv.com__redbrick.xpm
WE ./xpm_images/AnyConv.com__colorstone.xpm
EA ./xpm_images/AnyConv.com__greyston

F 51,153,255
C 224,224,224

         111111111111111111111111
         100000100000000000000001
  111111100000000000000000111111
  100000100000000111000001
  100000100000000000000001
  100000100000000000000001
  100000100000000000000001
  100000111111111000000001     111111
  100000000000000000000001     100001
  100000000000000000000001     111111
  100000000000000000000001
  100000101001000000000001
  100000101001000000000001
  100000101001000000000001
  100000101001000000000001
  100000101001000001000001
  100000101001000001000001
  100000000000000001000001
  1S0000000000000000000001
  111111111111111111111111