  111111111111111111111111
  1P0202020000000000000001
  100020200000000000000001
  100002020000000000000201
  100000202000000000002001
  100000020200000000020001
  100000002022222220200001
  100000000202000002000001
  100000000020200020000001
  100000022222000022220001
  100000000000000000000001
  100000000000000000000001
  100000000000000000000001
  100000000000000000000001
  100000000000000000000001
  100000000000000000000001
  100000000000000000000001
  100000000000000000000001
  100000000000000000000001
  100000000000000000000001
  100000000000000000000001
  100000000000000000000001
  100000000000000000000001
  111111111111111111111111
