NO ./xpm_images/jokin.xpm
SO ./xpm_images/AnyConv.com__redbrick.xpm
WE ./xpm_images/AnyConv.com__colorstone.xpm
EA ./xpm_images/AnyConv.com__greystone.xpm

F 225,0,0
C 225,0,0

  111111111111111111111111
  100000000000000000000001
  1N0000000000000000000001
  100000000000000000000001
  10000010000000000000100111111111111111111111111
  10000000000000000000000000000000000000000000001
  10000000000000000011111111111111111111100000001
  10000001000000000001000110000010000010000100001
  10000000100000000010000111000111110000000000001
  10000000010000000100000110101010101010101010101
  10000000000000000000000000000000000000000000001
  10000000001000001000000011111111111111111111111
  100000000001000100000001
  100000000000101000000001
  100000000000010000000001
  111111111111111111111111
