  111111111111111111111111
  1E0101010000000000000001
  100010100000000000000001
  100001010000000000000101
  100000101000000000001001
  100000010100000000010001
  100000001011111110100001
  100000000101000001000001
  100000000010100010000001
  100000011111000011110001
  100000000000000000000001
  100000000000000000000001
  100000000000000000000001
  100000000000000000000001
  100000000000000000000001
  100000000000000000000001
  100000000000000000000001
  100000000000000000000001
  100000000000000000000001
  100000000000000000000001
  100000000000000000000001
  100000000000000000000001
  100000000000000000000001
  111111111111111111111111
