NO ./xpm_images/AnyConv.com__eagle.xpm
SO ./xpm_images/AnyConv.com__redbrick.xpm
WE ./xpm_images/AnyConv.com__colorstone.xpm
EA ./xpm_images/AnyConv.com__greystone.xpm

F 220,100,0
C 225,30,0

         111111111111111111111111
         1000000000000000000000
  11111111000000000000001111111
  1S1111111111111111111111
  100000000000000000000001
  100000000000000010000001
  1000000000000001 10000001
  100000000000000010000001
  111111111111111111111111
  111111111111111111111111

  111111111111111111111111
  111111111111111111111111
  111111111111111111111111
  111111111111111111111111
  111111111111111111111111
  111111111111111111111111
  111111111111111111111111
  111111111111111111111111
  111111111111111111111111
  111111111111111111111111
