  333333333333333333333333
  300000000000000000000003
  300000000000000000000003
  300000000000000000000003
  300000000000000000000003
  300000000000000000000003
  300000000000000000000003
  300000000000000000000003
  300000000020000200000003
  300000000000000000000003
  300000000000000000000003
  300000000000P00000000003
  300000000000000000000003
  300000000000000000000003
  300000000000000000000003
  300000000000000000000003
  300000000000000000000003
  300000000000000000000003
  300000000000000000000003
  300000000000000000000003
  300000000000000000000003
  300000000000000000000003
  300000000000000000000003
  333333333333333333333333
